1111111111111111111111111
1000001001110001110002001
1000001001100000110001121
1000002001000000011111001
1000001002000000020002001
1000001001000000011211111
1111111001100000111011111
1111111001110001111011111
1111111001111211111011111
1111111002000000002011111
1111111001111111111011111
1111111000000000000011111
1111111001111111111111111
1111111001111111111111111
1111111221111111111111111
1000000000000000000000001
1000000000000000000000001
1000000000000000000000001
1000000000001000000000001
1000000000011100000000001
1000000000001000000000001
1000000000000000000000001
1000000000000000000000001
1000000000000000000000001
1111111111111111111111111